NO ./textures/wall.xpm
SO ./textures/wall.xpm
WE ./textures/wall.xpm
EA ./textures/wall.xpm

C 0,0,0
F 42,42,42

1111111111111111111111111111111
1000000000001000000000000000001
1011111111101011111111111111101
1010000000101000000000000010001
1010111110101111111111111010111
1010100010100000000000010010001
1010101010111111111111011011101
1010101000001000000010000010001
1010111111101011111010111110101
1010000000101010000010100000101
1011111010101010111110101111101
1000001010000010100000101000001
1111101011111110101111101011111
1000101000000010101000001000001
1011101111111010101011111111101
1010001000001010001010000000101
1010111011101011111010111110101
1010100010001000000010000010101
1010101110111111111111111010101
1010101000100000000000001010001
1011101011101111111111101011111
1000001000001000000000101000001
1011111111101011111110101111101
1010000000000010000010100000N01
1111111111111111111111111111111