
NO ./textures/wall.xpm
SO ./textures/wall.xpm

WE ./textures/wall.xpm
EA ./textures/wall.xpm

F 220,10,30
C 225,0,150

    1111111111111111111111111
    1000000000110000000000001
    1011000001110000000000001
    1001000000000000000000001
111111111011000001110000000000001
100000000011000001110111111111111
11110111111111011100000010001
11111111111111011101010010001
11000000110101111100000010001
10000000000000001100000010001
10000000N0000000110101  1011
1100000111010101111111111011
11110111 1110101 101111010101
11111111 1111111 11111111111101
1111111111111111111111111111
11111111111111111111111111111