NO ./textures/wall.xpm
SO ./textures/wall.xpm
WE ./textures/wall.xpm
EA ./textures/wall.xpm

C 0,0,0
F 42,42,42

1111111111111111111111111111111111111
1000000000000000010000000000000000001
1011111111111111010111111111111111101
1010000000000010010000000000000000101
1010111111111010111111111111111110101
1010100000010010000000000010000010101
1010101111011111111111111010111010101
1010101000010000000000001010100010101
1010101011110111111111101010101110101
1010001000000100001000001010001000101
1011111011111101101011111011111011101
1000000010000000101000000010000010001
1111111010111111101111111010111110101
1000001010100000001000001010100010101
1011101010101111111011101010101010101
1010001010001000000010001010001010101
1010111011111011111110111011111010101
1010100000000010000010000010000010101
1010101111111010111010111110111110101
1010101000001010100010100000100000101
1011101011101010101110101111101111101
1000001000100010101000101000001000001
1011111110111110101011101011111011101
1010000000100000101000001000000010C01
1010111111101111101111111111111011101
1010000010001000000000000000100010001
1011111010101011111111111110101110101
1000001010101000000010000010100010101
1011101010101111111010D1010111010101
1010000010100000001010001010000010101
1010111110110111101011101011111110101
101000000000C0000101000101000000010101
1011111101110110101110101111111010101
1000000000000010100000100000001C00D01
1011111010011010111111111111101111101
100000000C0000000000000D0000000001N11
1111111111111111111111111111111111111